＠＠＠＠＠＠＠＠＠＠＠＠＠＠＠＠＠＠＠＠＠＠＠＠＠＠＠＠＠＠＠＠＠＠＠＠＠＠＠＠
＠　　　　　　　　　　　　　　　　　　　　　　　　　　　　　　　　　　　　　　＠
＠　　　　　　　　　　　　　　　　　　　　　　　　　　　　　　　　　　　　　　＠
＠　　　　　　　　　　　　　　　　　　　　　　　　　　　　　　　　　　　　　　＠
＠　　　　　　　　　　　　　　　　　　　　　　　　　　　　　　　　　　　　　　＠
＠　　　　　　　　　　　　　　　　　　　　　　　　　　　　　　　　　　　　　　＠
＠　　　　　　　　　　　　　　　　　　　　　　　　　　　　　　　　　　　　　　＠
＠　　　　　　　　　　　　　　　　　　　　　　　　　　　　　　　　　　　　　　＠
＠　　　　　　　　　　　　　　　　　　　　　　　　　　　　　＠＠　＠　　　　　＠
＠　　　　　　　　　　＠＠　　　　　　　　　　　　　　　　　　　　　　　　　　＠
＠　　　　　　　　　　　＠　　　　　　　　　　　　　　　＠　　　　　　　　　　＠
＠　　　　　　　　　　　　　　＠＠　　　　　　　　　　＠　　　　　　　　　　　＠
＠　　　　　　　　　　　　　　　　＠　　　　　　　　　　　　　　　　　　　　　＠
＠　　　　　　　　　　　　　　　　　　　　　　　　　　　　　　　　　　　　　　＠
＠　　　　　　　　　　　　　　　＠　　　　　　　　　　　　　　　　　　　　　　＠
＠　　　　　　　　　　　　　　　　＠　　　　　　　　　　　　＠　　　　　　　　＠
＠　　　　　　　　　　　　　　　　　＠　　　　　　　　　　　＠　　　　　　　　＠
＠　　　　　　　　　　　　　　　　　　　　　　　　　　　　　＠　　　　　　　　＠
＠　　　　　　　　＠　　　　　　　　　　　　　　　　　　　　＠　　　　　　　　＠
＠　　　　　　　　　　　　　　　　　　　　　　　　　　　　　　　　　　　　　　＠
＠　　　　　　　　　　　　　　　　　　　　　　　　　　　　　　　　　　　　　　＠
＠　　　　　　　　＠＠　　　　　　　　＠　＠　　　　　　　　　　　　　　　　　＠
＠　　　　　　　　＠＠　　　　　　　　＠　　＠　　　　　　　　　　　　　　　　＠
＠　　　　　　　　＠＠　　　　　　　　＠　＠　　　　　　　　　　　　　　　　　＠
＠　　　　　　　　　　　　　　　　　＠　　＠　　　　　　　　　　　　　　　　　＠
＠　　　　　　　　　　　　　　　　　　　　　　　　　　　　　　　　　　　　　　＠
＠　　　　　　　　　　　　　　　　　　　　　　　　　　　　　　　　　　　　　　＠
＠　　　　　　　　　　　　　　　　　　　　　　　　　　　　　　　　　　　　　　＠
＠　　　　　　　　　　　　　　　　　　　　　　　　　　　　　　＠＠　　　　　　＠
＠　　　　　　　　　　　　　　　　　　　　　　　　　　　　　　＠＠　　　　　　＠
＠　　　＠＠＠　　　　　　　　　　　　　　＠＠＠　　　　　　＠　　　　　　　　＠
＠　　　　　　　　　　　　　　　　　　　　＠　　＠　　　　＠　　　　　　　　　＠
＠　　　　　　＠　　　　　　　　　　　　　＠　　　＠＠＠＠　　　　　　　　　　＠
＠　　　　　　　　　　＠　　　　　　　　　＠　　　　　　　　　　　　　　　　　＠
＠　　　　　　　　　　　　　　　　　　　　＠　　　　　　　　　　　　　　　　　＠
＠　　　　　　　　　　　　　　　　　　　　　　　　　　　　　　　　　　　　　　＠
＠　　　　　　　　　　　　　　　　　　　　　　　　　　　　　　　　　　　　　　＠
＠　　　　　　　　　　　　　　　　　　　　　　　　　　　　　　　　　　　　　　＠
＠　　　　　　　　　　　　　　　　　　　　　　　　　　　　　　　　　　　　　　＠
＠＠＠＠＠＠＠＠＠＠＠＠＠＠＠＠＠＠＠＠＠＠＠＠＠＠＠＠＠＠＠＠＠＠＠＠＠＠＠＠
